{
	"numTilesX": 14,
	"numTilesY": 10,
	"size": [64,64],
	"start":[-46,-16],
	"tileNames":["","tile01","tile02","tile03"],
	"tiles":[
		2,2,2,2,2,2,2,2,2,2,2,2,2,2,
		2,1,1,1,1,1,1,1,1,1,1,1,1,2,
		2,1,1,1,1,1,1,1,1,1,1,1,1,2,
		2,1,1,1,1,1,1,1,1,1,1,1,1,2,
		2,1,1,1,1,1,1,1,1,1,1,1,1,2,
		2,1,1,1,1,1,1,1,1,1,1,1,1,2,
		2,1,1,1,1,1,1,1,1,1,1,1,1,2,
		2,1,1,1,1,1,1,1,1,1,1,1,1,2,
		2,1,1,1,1,1,1,1,1,1,1,1,1,2,
		3,3,3,3,3,3,3,3,3,3,3,3,3,3
		]
}