{
	"numTilesX": 14,
	"numTilesY": 10,
	"size": [64,64],
	"start":[-46,-16],
	"tileNames":["","tile01","tile02","tile03"],
	"tiles":[
		2,2,2,2,2,2,2,2,2,2,2,2,2,2,
		2,0,0,0,0,0,0,0,0,0,0,0,0,2,
		2,0,0,0,0,0,0,0,0,0,0,0,0,2,
		2,0,0,0,0,0,0,0,0,0,0,0,0,2,
		2,0,0,0,0,0,0,0,0,0,0,0,0,2,
		2,0,0,0,0,0,0,0,0,0,0,0,0,2,
		2,0,0,0,0,0,0,0,0,0,0,0,0,2,
		2,0,0,0,0,0,0,0,0,0,0,0,0,2,
		2,0,0,0,0,0,0,0,0,0,0,0,0,2,
		3,3,3,3,3,3,3,3,3,3,3,3,3,3
		]
}